G
1
Z
1
################
#..............#
#..####..####..#
#..####..####..#
#..............#
################
