G
2
Z
2
################
#.....#..#.....#
#..####..####..#
#..............#
#....######....#
#..#        #..#
#..#        #..#
#....######....#
#..............#
#..####..####..#
#.....#..#.....#
################