G
3 
Z
2
#################
#...............#
#.#.#.#.#.#.#.#.#
#.#.#.#.#.#.#.#.#
#.#.#.#.#.#.#.#.#
#.#.#.#.#.#.#.#.#
#...............#
#################

