G
5
Z
5
            #            #
          #...#        #...#
         #.....#      #.....#
   #    #.......######.......#     #
    # #...........P............#  #
     #..........................##
    ###......#...........#......###
   ######...###.........###...######
  ########...#...........#...########
 ##########................###########
   ######........####........#######
    ####........######........####
     #.......... ####...........#
    #  #......................#  #
   #     ###..............###     #
            ###........###
               ########