G
5
G
5

#################################
#............#.####.#...........#
######.#####.#.####.#.####.######
#...............................#
####.###.#####.###.####.###.#####
#...............................#
######.#######.####.#######.#####
#..............####.............#
######.#######.####.#######.#####
#...............................#
####.###.#####.###.####.###.#####
#...............................#
######.#####.#.####.#.####.######
#............#.####.#.####......#
#################################
