G
6
Z
6
##################
#................#
#.#.##########.#.#
#.#..............#
#.#.######.###.#.#
#.#.#............#
#.#.#.####.###.#.#
#.#.#.####.###.#.#
#.....####.###...#
#.#.#.####.###.#.#
#.#.#.####.###.#.#
#.#.#............#
#.#.######.###.#.#
#.#..............#
#.#.##########.#.#
#................#
##################
