Z //Number of Zones
10
D //Ghost Details, Row1: Health, Row2: Speed, Row3: Respawn Delay, Row4: ZoneID
2222222222
1111111111
3333333333
0123456789
S //Minimum Score
12000
#########################
#..d.....#######........#
#.######.#######.######.#
#.######.........######.#
#........#######........#
###.####.#######.####.###
#...####....#....####...#
#.#.#######.#.#######.#.#
#.#....###..#..###.s..#.#
#.####.###.###.###.####.#
#.####.#....P....#.####.#
#...##...###.###...##...#
###.####.###.###.####.###
#........###.###........#
#.######.###.###.######.#
#.###...............###.#
#.....######.######.....#
#####.###.......###.#####
#####.###.#####.###.#####
#.......................#
#.###.######.######.###.#
#.....######H######.....#
#.###......#.#......###.#
#.....####.....####.....#
#########################