Z //Number of Zones
9
D //Ghost Details, Row1: Health, Row2: Speed, Row3: Respawn Delay, Row4: ZoneID
111111111
111111111
555555555
012345678
S //Minimum Score
9000
#################################
#.............................M.#
#.###########.#####.###########.#
#.###########.#####.###########.#
#.###########.#####s###########.#
#.##########..#####..##########.#
#...............P...............#
#.##########H.#####..##########.#
#.###########.#####.###########.#
#.###########.#####.###########.#
#.###########.#####.###########.#
#...d...........................#
#################################