Z //Number of Zones
3
D //Ghost Details, Row1: Health, Row2: Speed, Row3: Respawn Delay, Row4: ZoneID
11111
21112
55555
00122
S //Minimum Score
5000


###################################
#...............................P.#
#......####################.......#
#.....#...........................#
#..#####...................#......#
#.#..s..#..##........##....#......#
#.#.....#..##........##....#......#
#.#.. ##...................#......#
#..#.##....############....#......#
#..#.##....#..........#....#......#
#..#.##....#..........#....###....#
#..#............H.............#...#
#..####....#..........#....#..#...#
#.....#....#..........#....#..#...#
#.....#....############...##..#...#
#.....#..................#.....#..#
#.....#..................#.....#..#
#.....#...................#####...#
#.....##..................##......#
#.....#..##............##..#......#
#.....#...##############...#......#
#.....#......#......#......#......#
#.....#......#......#...d..#......#
#.....#......#......#......#......#
#.....#######........#######......#
#.................................#
###################################