Z //Number.of.Zones
4
D //Ghost Details, Row1: Health, Row2: Speed, Row3: Respawn Delay, Row4: ZoneID
111111
111111
444444
001233
S //Minimum Score
4000
###################################
#.................................#
#......####.............####......#
#....########.........########.s..#
#...##########.......##########...#
#..#..####..###.....#..####..###..#
#......##....##..P......##....##..#
#.........H..##............H..##..#.
#.#....##....###...#....##....###.#
#.##..####..####...##..####..####.#
#.##############...##############.#
#.##############...##############.#
#.##############...##############.#
#.##############...##############.#
#.##.###..###.##...##.###..###.##.#
#.#...##..##...#...#...##..##...#.#
#d................................#
###################################