Z //Number.of.Zones
4
D //Ghost Details, Row1: Health, Row2: Speed, Row3: Respawn Delay, Row4: ZoneID
112211
121121
444444
001233
S //Minimum Score
8000
###################################
#.................................#
#......####.............####......#
#....########.........########.s..#
#...##########.......##########...#
#..#..####..###.....#..####..###..#
#......##....##..P......##....##..#
#.........H..##............H..##..#.
#.#....##....###...#....##....###.#
#.##..####..####...##..####..####.#
#.##############...##############.#
#.##############...##############.#
#.##############...##############.#
#.##############...##############.#
#.##.###..###.##...##.###..###.##.#
#.#...##..##...#...#...##..##...#.#
#d...............................M#
###################################