Z //Number.of.Zones
3
D //Ghost Details, Row1: Health, Row2: Speed, Row3: Respawn.Delay, Row4: ZoneID
111
111
555
012
S //Minimum.Score
2000
########################
#......................#
#.#####..#####..######.#
#.#..................#.#
#.#.###..#####..####.#.#
#.#.#..............#.#.#
#.#.#.############.#.#.#
#......................#
#.#.#.#..........#.#.#.#
#.#.#.#.#.....#..#.#.#.#
#.#.#.#.#..P..#..#.#.#.#
#.#.#.#.#.....#..#.#.#.#
#.#.#.#.#######..#.#.#.#
#......................#
#.#.#.############.#.#.#
#.#.#..............#.#.#
#.#.####..#####..###.#.#
#.#..................#.#
#.######..#####..#####.#
#......................#
########################