Z //Number.of.Zones
3
D //Ghost Details, Row1: Health, Row2: Speed, Row3: Respawn.Delay, Row4: ZoneID
111
222
777
012
S //Minimum.Score
5000
########################
#.H....................#
#.#####..#####..######.#
#.#..................#.#
#.#.###..#####..####.#.#
#.#.#..............#.#.#
#.#.#.############.#.#.#
#s.....................#
#.#.#.#..........#.#.#.#
#.#.#.#.#.....#..#.#.#.#
#.#.#.#.#..P..#..#.#.#.#
#.#.#.#.#.....#..#.#.#.#
#.#.#.#.#######..#.#.#.#
#.....................H#
#.#.#.############.#.#.#
#.#.#..............#.#.#
#.#.####..#####..###.#.#
#.#..................#.#
#.######..#####..#####.#
#.....d................#
########################