Z //Number of Zones
6
D //Ghost Details, Row1: Health, Row2: Speed, Row3: Respawn Delay, Row4: ZoneID eat my pills
1231232
1111112
5555555
0123455
S //Minimum Score
2000
########################################
#............................H........##
#.#####.#####.###.# ####.#.###.## ##.###
#.#####.#####.###.# ####.#.###....#...##
#.#####.#####.###.# ####.#.###....##.###
#...........#.....#P####.#.............#
#####.#.#####.###.#.####.#.............#
#####.#.#####.###.#.####.#.............#
#####.#.#####.###.#.####.#.............#
#.....d.......###...####.#.............#
########################################