Z //Number of Zones
5
D //Ghost Details, Row1: Health, Row2: Speed, Row3: Respawn Delay, Row4: ZoneID
22222
11111
44444
01234
S //Minimum Score
12000
#######################
#.....................#
#.########.#.########H#
#....#.....#.....#....#
##.#.#.#########.#.#.##
#..#...............#..#
#.##.#.###.#.###.#.##s#
####.#.#########.#.####
####H#.....P.....#.####
####.#.####.####.#.####
####.#.#########.#.####
####.#...........#.####
####.#####.#.#####.####
#....#.....#.....#....#
#.##.#.###.#.###.#.##.#
#.##.#####.#.#####.##.#
#.##.#####.#.#####d##.#
#.....................#
#######################
