Z //Number of Zones
1
D //Ghost Details, Row1: Health, Row2: Speed, Row3: Respawn Delay, Row4: ZoneID
1
2
1
0
S //Minimum Score
2000
#############################################
#...........................................#
#...........................................#
#  P                                        #
#...........................................#
#...........................................#
#############################################