Z //Number of Zones
5
D //Ghost Details, Row1: Health, Row2: Speed, Row3: Respawn Delay, Row4: ZoneID
22222
11111
55555
01234
S //Minimum Score
2000
##################################
# P..............................#
#................................#
###############################..#
#                             #..#
###############################..#
#................s...............#
#..###############################
#..#                             #
#..###############################
#.......H..........d.............#
###############################..#
#                             #..#
###############################..#
#................H...............#
#..###############################
#..#                             #
#..###############################
#................................#
##################################