Z //Number of Zones
6
D //Ghost Details, Row1: Health, Row2: Speed, Row3: Respawn Delay, Row4: ZoneID eat my pills
123123
111111
555555
012345
S //Minimum Score
2000
########################################
#............................H........##
#.#####.#####.###.# ####.#.###.## ##.###
#.#####.#####.###.# ####.#.###....#...##
#.#####.#####.###.# ####.#.###....##.###
#...........#.....#P####.#.............#
#####.#.#####.###.#.####.#.............#
#####.#.#####.###.#.####.#.............#
#####.#.#####.###.#.####.#.............#
#.....d.......###...####.#.............#
########################################