Z //Number of Zones
3
D //Ghost Details, Row1: Health, Row2: Speed, Row3: Respawn Delay, Row4: ZoneID
212
121
454
012
S //Minimum Score
10000
###############################
#H............................#
#.#.#.###.#####.#####.###.#.#.#
#...#.#.....#.....#.....#.#...#
#.###.#.#.#####.#####.#.#.###.#
#.......#.............#.......#
#.###.###.###.###.###.###.###.#
#.......#......P......#.......#
#.###.#.#.#####.#####.#.#.###.#
#...#.#.....#.....#.....#.#s..#
#.#.#.###.#####.#####.###.#.#.#
#.................d...........#
###############################