Z //Number of Zones
3
D //Ghost Details, Row1: Health, Row2: Speed, Row3: Respawn Delay, Row4: ZoneID
2122
1211
5555
0012
S //Minimum Score
9000
#######################
#.....................#
#.#.#.###########.#.#.#
#...#.###########.#...#
#.###.###########.###.#
#H....................#
#.###.##.#####.##.###.#
#.###.#....#....#.###.#
#.###.#.#.###.#.#.###.#
#.###...#..P..#...###.#
#.###.#.#.###.#.#.###.#
#.###.#....#....#.###.#
#.###.##.#####.##.###.#
#.........M..........d#
#.###.###########.###.#
#...#.###########.#...#
#.#.#.###########.#.#.#
#....................s#
#######################