Z //Number of Zones
2
D //Ghost Details, Row1: Health, Row2: Speed, Row3: Respawn Delay, Row4: ZoneID
11
11
55
01
S //Minimum Score
2000
###############################
#H............................#
#.#.#.###.#####.#####.###.#.#.#
#...#.#.....#.....#.....#.#...#
#.###.#.#.#####.#####.#.#.###.#
#.......#.............#.......#
#.###.###.###.###.###.###.###.#
#.......#......P......#.......#
#.###.#.#.#####.#####.#.#.###.#
#...#.#.....#.....#.....#.#s..#
#.#.#.###.#####.#####.###.#.#.#
#.................d...........#
###############################