Z //Number of Zones
6
D //Ghost Details, Row1: Health, Row2: Speed, Row3: Respawn Delay, Row4: ZoneID
221122
112211
555555
012345
S //Minimum Score
12000
###########################
#......#...........#......#
#......#...........#......#
#..##..#...#####...#..##..#
#H.#...................#..#
#..#..###..#..##..###..#.s#
#..........#.P.#..........#
#..........#...#..........#
#..#..###..##..#..###..#..#
#..#...................#..#
#..##..#...#####...#..##..#
#......#...........#......#
#M.....#..........d#......#
###########################